256 ────────────────┐241
225┌────────────────┘240
224└────────────────┐209
193┌────────────────┘208
192└────────────────┐177
161┌────────────────┘176
160└────────────────┐145
129┌────────────────┘144
128└────────────────┐113
097┌────────────────┘112
096└────────────────┐081
065┌────────────────┘080
064└────────────────┐049
033┌────────────────┘048
032└────────────────┐016
000 ────────────────┘015
